###########  
P  X      #  
#  ##  #  #  
#      #  # #
# #  ###### #
# #       X #
# #   # #E#  
#######E###  