###############
#      P      #
#####     #####
#             #
#####     #####
#E            #
#####     #####
#             #
###############